  ###########################
    #   #       #           #
### # # # ### ### ### ##### #
# #   # #   # #   # #     # #
# ##### # # # # ### ##### # #
#     # # # # # #     # # # #
### ### # # ### ### # # # ###
#   #   # #   # #   # # #   #
# ### ### ### # # ### # ### #
# #   # #   #   # #   #   # #
# # ### ### ##### ### # ### #
#   #   #   #       # # #   #
# ### ### ######### # # # ###
# #             #   #   #   #
# ############# # ##### ### #
#           #     # #     # #
########### ####### # ##### #
#         #     #   # # #   #
# ############# # ### # # # #
#     #       # #     # # # #
##### # ### # # # ##### # ###
#     #   # # # #     # #   #
# ####### # ### ##### # ### #
#         #   #     # # #   #
# ########### ##### # # # ###
#     # #     #     #   #   #
##### # # ##### ########### #
#       #                    
###########################  
