  ###########################
  #     #           # #     #
#O### # ####### ### # # ### #
# #   #         #   # #   # #
# # ############# ### ### # #
# # #           #   #     # #
# # # ##### ####### # ##### #
# # # #     #     # # #     #
# # ### ### # ### # # # ### #
# # #   #   # # # # # #   # #
# # # ##### # # # # ##### # #
#   # #   # # # # #       # #
##### # # ### # # ######### #
#     # #   # # #   #   #   #
# ##### ### # # ### # # # ###
#       #   #     #   # # # #
# ####### # ##### ##### # # #
#   #   # # #     #   # #   #
### # # # ### ####### # ### #
# # # # #     #       #     #
# # ### ####### ### # #######
# #   #         #   # #   # #
# ### # ######### ### # # # #
#   # #   #   #   # #   # # #
# # # # ### # # ### ##### # #
# # # # #   #   #   #   # # #
# # # ### ####### ### # # # #
# #       #           #      
###########################  
